XXXXXXX2222XXXXXXX
X          R   H0X
X                X
X               UX
X                X
X                X
X    XX   XH1    X
X     X XX       X
X D  SXX         X
X     X XX H2    X
X    XX   X      X
X                X
X              D X
X     B2         X
X                X
X         R    H0X
X                X
XXXXXXX1111XXXXXXX
